111111111111111
1EC10P000000001
110100000000001
100000000100001
101110000101101
100C0000C010001
101101110111101
100010000000001
111111111110111
100C00000000001
1011100C0101101
100000010100001
101111111111111
100000000000001
111111111111111