1111111111111111111111111111111111111111
1E1110000000000C00000C00000000000P111111
1011110100100000101001000000010101111101
1010010010101010001001000000010101000001
100011111C00C0000111111100000000C1001001
1001111111111100C00000000C00000001010111
10000C0000C000000000C00000000C0001000001
100001111111110C0001111110C0000001111111
1000000C0000111111C111111110C00001000001
1C000C0000000C00011111C00000000000000001
1000000000C11111111111000000000000000001
1000000000000000C00000000C00000000000001
1111111111111111111111111111111111111111